11111111111111111111111111111111
11.1.1.121.....11....1P1.1.1.1.1
1.1.1.1...1...1..1...1..1.1.1.11
11.1.1..1..1.1....1.1....1.1.1.1
1.1.1..1.1..1......1..11..1.1.11
11.1..1...1..1....1..1..1..1.1.1
1.1..1.....1..1..1..1....1..1.11
11..1.......1..11..1......1..1.1
1.1..1.....1........1....1...111
11.1..1...1..........1..1...1.11
1.1.1..111............11...1.1.1
1..1.1....1..........1....1.1.11
1.1.1.1....1........1....1.1.1.1
1..1.1.1....1......1....1.1.1.11
1.1.1.1.1....1....1....1.1.1.1.1
1..1.1.1.1....1..1....1.1.1.1.11
1.1.1.1.1....1....1....1.1.1.1.1
11.1.1.1....1......1....1.1.1.11
1.1.1.1......1....1......1.1.1.1
1........111111..111111........1
1..............................1
1....11111.1111K111.11111......1
1..............................1
11111111111111111111111111111111